WBEDP	Wristband	WBEDP
PPR6	Letter	PPR6
DC5	OCM and Reports	DC5
WBJW	Wristband	WBJW
WBNNU	Wristband	WBNNU
WBCOT1	Wristband	WBCOT1
WBM1	Wristband	WBM1
WBBC	Wristband	WBBC
WBM3	Wristband	WBM3
MAF4	OCM and Reports	MAF4
WBEDR	Wristband	WBEDR
AE14	OCM and Reports	AE14
WBXRA	Wristband	WBXRA
WBDMOP	Wristband	WBDMOP
WBMS	Wristband	WBMS
WBOPT	Wristband	WBOPT
WBEDM	Wristband	WBEDM
WBTHA	Wristband	WBTHA
PPR11	Letter	PPR11
PPR1	Letter	PPR1
GOP1	OCM and Reports	GOP1
OPB1	OCM and Reports	OPB1
XBMO	OCM and Reports	XBMO
XBV2	OCM and Reports	XBV2
XACT	OCM and Reports	XACT
XMU	OCM and Reports	XMU
FER1	OCM and Reports	FER1
NEO	OCM and Reports	NEO
EPU	OCM and Reports	EPU
MAT11	Letter	MAT11
MAT12	OCM and Reports	MAT12
DCCL	OCM and Reports	DCCL
PR6	Letter	PR6
DJAS	OCM and Reports	DJAS
DMAU	OCM and Reports	DMAU
JAU	OCM and Reports	JAU
CHC2	OCM and Reports	CHC2
